ScriptManager	menu item	Script Manager	ScriptManagerMenuItem.s	Scripts	
Useful	library	useful.s
MatrixMath	library	matrixMath.s
Size	library	SizeLib.s
SameSize	menu item	Same	sameSize.s	Window	Size
ZoomSize	menu item	Zoom	zoomSize.s	Window	Size
FitSize	menu item	Fit	fitSize.s	Window	Size
FullSize	menu item	Full	fullSize.s	Window	Size
JEM Tags	library	JEM_Tags_lib.s
JEM Lib offline	library	JEM_Lib_offline.s
JEM Prefs	library	JEM_Prefs.s
DigiScanSim	library	DigiScanSim.s
DataManager	library	DataManager.s
JEM Data	library	JEM_Data.s
JEM Object	library	JEM_Object.s
JEM Thread	library	JEM_Thread.s
JEM Dialog	library	JEM_Dialog.s
JEM_Widget	library	JEM_Widget.s
JEM Lens	library	JEM_Lens.s
JEM_Corr	library	JEM_Corr.s
JEM_Comp	library	JEM_Comp.s
JEM Align Files	library	JEM_AlignFiles.s
Tiffen	library	Tiffen.s
Flatten	library	FlattenLib.s
FFT_AnythingLib	library	FFT_anything_lib.s
FFT Anything	menu item	FFT Anything	FFT_anything_DLG.s	Process	
CameraMngrSim	library	CameraMngrSim.s
Gatan Camera	library	GatanCamera.s
CameraCalib	library	CameraCalib.s
Alignment	technique	Alignment	JEM-2100	target.tif
Acquisition	technique	Acquisition	JEM-2100	acquire.tif
ExposureLib	library	Exposure.s
Exposure	task	Exposure	Exposure	     0	Acquisition	     1	     1
ProgInfoLib	library	ProgressInfo.s
ProgInfo	widget	Progress Info	ProgressInfo	panel	     0
AcqControl	library	AcqControl.s
AcqCtrl	task	Acquisition Control	AcqControl	     0	Acquisition	     1	     1
SmartAcqLib	library	SmartAcq.s
SmartAcq	task	Smart Acquire	SmartAcq	     0	Acquisition	     1	     1
MagCalibMode	library	MagCalibMode.s
DefCalibLib	library	DefCalib.s
DefCalib	task	Deflector Calibration	DefCalib	     0	Alignment	     0	     0
MontageLib	library	Montage.s
Montage	task	Montage	Montage	     0	Acquisition	     0	     0
JEM Series	library	JEM_Series.s
Series	widget	Series	JEM_Series	panel	     0
ScaleMarkerLib	library	ScaleMarker.s
Scale Marker	widget	Scale Marker	ScaleMarker	panel	     0
LoadAlign	menu item	Load	AlignFilesLoad.s	JEM-2100	Align
SaveAlign	menu item	Save	AlignFilesSave.s	JEM-2100	Align
Stop	menu item	Stop	terminate.s	JEM-2100	
ChangeCalibration	library	ChangeCalibration.s
LensWobblerLib	library	LensWobbler.s
DefWobblerLib	library	DefWobbler.s
Flatten Dialog	menu item	Flatten	FlattenDialog.s	Process	
Auto FFT	menu item	Auto FFT	auto_fft.s	Process	
DigiScan	task	Scan		     1	Acquisition	     0	     0
LensWobbler	task	Lens Wobbler	LensWobbler	     0	Alignment	     0	     0
DefWobbler	task	Deflector Wobbler	DefWobbleControl	     0	Alignment	     0	     0
SmartAcq_STEM_Lib	library	SmartAcq_STEM.s
SmartAcq_STEM	task	SmartAcquire STEM	SmartAcq_STEM	     0	Acquisition	     0	     0
Uncalibrate	menu item	Uncalibrate	uncalibrate.s	Process	Calibration
ChangeCalibDlg	menu item	Change	ChangeCalibrationDlg.s	Process	Calibration
CopyCalibDlg	menu item	Copy	copy_calibration.s	Process	Calibration
MakeGrayscaleDlg	menu item	Make Grayscale	make_grayscale.s	Display	
